#########
############   #####

### ### ##### ###

######## B ########
######   #########
##  ## ## ## #####
####  ##### ######
## ###############
####  ###########
######## A ######
#################
